XXXXXXXXX
XOOOOOXOX
XXXOXOOXX
XOXOOXXXX
XXXXOOXOX
XXXXXOOXX
XOOOOOOOX
XXXOXXXOX
XXXXXXXXX
